{0, 3, 2, 3, 2, 8, 0, 0, 1, 8, 5, 2, 5, 0, 5}, 
{0, 4, 1, 4, 1, 7, 1, 0, 0, 7, 2, 3, 0, 0, 1}, 
{0, 0, 3, 2, 3, 8, 0, 1, 1, 8, 5, 1, 5, 1, 5},
{1, 4, 1, 4, 1, 7, 1, 0, 0, 7, 3, 2, 3, 2, 3},
{2, 3, 2, 3, 2, 8, 0, 0, 1, 8, 5, 1, 5, 1, 5},
{3, 4, 3, 4, 3, 7, 1, 1, 0, 0, 2, 3, 2, 3, 2},
{7, 8, 7, 8, 7, 8, 0, 0, 1, 8, 7, 8, 7, 8, 7},
{2, 3, 2, 3, 2, 0, 1, 0, 0, 7, 2, 4, 2, 4, 2},
{6, 1, 6, 1, 6, 8, 0, 1, 1, 8, 3, 2, 3, 2, 3},
{3, 2, 3, 2, 3, 7, 1, 0, 0, 7, 1, 4, 1, 4, 1},
{6, 0, 6, 1, 6, 8, 0, 0, 1, 8, 2, 3, 2, 3, 0},
{0, 0, 2, 3, 2, 7, 1, 1, 0, 7, 1, 4, 1, 4, 0},
{6, 0, 6, 2, 6, 8, 0, 0, 1, 8, 3, 2, 3, 0, 0},